29 29

G T S T T T T T T O O O O T W W W W W W W W W W W W W W W W
T T T T T T T T T O O O O T O O O O O O O O O O O O O O O O
T G G G G G G G G O O O O T O O O O O O O O O O O O O O O O
G G G G G G G G G O O O O T O O O O O O O O O O O O O O O O
T T T T T T G G G O O O O T O O O O O O O O O O O O O O O O
S S S S S S S S G O O O O T O O O O O O O O O O O O O O O O
S S S S S S S S S O O O O T O O O O O O O O O O O O O O O O
S S S S S S S S S O O O O T O O T O O O O O O O O O O O O O
S S S S S S S S S O O O O T O O T O O O O O O O O O O O O O
S G G G G S S S S O O O O T T T T O O O O O O O O O O O O O
S G T T G S S S S O O O O O O O O O O O O O O O O O O O O O
S G G T G S S S S O O O O O O O O O O O O O O O O O O O O O
S G T T G S S S S O O O O O O O O O O O O O O O O O O O O O
W S W W W W W W W W W W W W O O W W W W W W W W W W W W W W
S S S S S S S S S O O O O O O O O O O O O O O O O O O O O O
S S S S S S S S S O O O O O O O O O O O O O O O O O O O O O
S S S S S S S S S O O O O O O O O O O O O O O O O O O O O O
S S S S S S S S S O O O O O O O O O O O O O O O O O O O O O
S S S S S S S S S O O O O O O O O O O O O O O O O O O O O O
S S S S S S S S S O O O O O O O O O O O O O O O O O O O O O
S S S S S S S S S O O O O O O O O O O O O O O O O O O O O O
S S S S S S S S S O O O O O O O O O O O O O O O O O O O O O
S S S S S S S S S O O O O O O O O O O O O O O O O O O O O O
S S S S S S S S S O O O O O O O O O O O O O O O O O O O O O
S S S S S S S S S O O O O O O O O O O O O O O O O O O O O O
W W W W S S S S S O O O O O O O O O O O O O O O O O O O O O
W W W W S S S S S O O O O O O O O O O O O O O O O O O O O O
W W W W W W W W W W W W W W W W O O O O O O O O O O O O O O
S S S S S S S S S O O O O O O O O O O O O O O O O O O O O O
S S S S S S S S S O O O O O O O O O O O O O O O O O O O O O
