48 48

G T S T T T T T T O O O O T W W W W W W W W W W W W W W W W W W W W W W W W W W W W W W W W W W W
T T T T T T T T T O O O O T O O O O O O O O O O O O O O O O W W W W W W W W W W W W W W W W W W W
T G G G G G G G G O O O O T O O O O O O O O O O O O O O O O W W W W W W W W W W W W W W W W W W W
G G G G G G G G G O O O O T O O O O O O O O O O O O O O O O W W W W W W W W W W W W W W W W W W W
T T T T T T G G G O O O O T O O O O O O O O O O O O O O O O W W W W W W W W W W W W W W W W W W W
S S S S S S S S G O O O O T O O O O O O O O O O O O O O O O W W W W W W W W W W W W W W W W W W W
S S S S S S S S S O O O O T O O O O O O O O O O O O O O O O W W W W W W W W W W W W W W W W W W W
S S S S S S S S S O O O O T O O T O O O O O O O O O O O O O W W W W W W W W W W W W W W W W W W W
T T T T T T T T T O O O O T O O T O O O O O O O O O O O O O W W W W W G G G G G G G G G G G W W W
S G G G G S S S S O O O O T T T T O O O O O O O O O O O O O W W W W G G G G G G G G G G G G W W W
S G T T G S S S S O O O O O O O O O O O O O O O O O O O O O W W W W G G G G G G G G G G G G W W W
S G G T G S S S S O O O O O O O O O O O O O O O O O O O O O W W W W G G G G G F F G G G G G W W W
S G T T G S S S S O O O O O O O O O O O O O O O O O O O O O W W W W G G G G G F F G G G G G W W W
W W W W W W W W W W W W W W O O W W W W W W W W W W W W W W W W W W G G G G G G G G G G G G W W W
S S S S S S S S S O O O O O O O O O O O O O O O O O O O O O W W W W G G G G G G G G G G G G W W W
S S S S S S S S S O O O O O O O O O O O O O O O O O O O O O W W W W G G G G G G G G G G G G W W W
S S S S S S S S S O O O O O O O O O O O O O O O O O O O O O S S S S G G G G G G G G G G G W W W W
S S S S S S S S S O O O O O O O O O O O O O O O O O O O O O W W W W W W W W W W W W W W W W W W W
S S S S S S S S S O O O O O O O O O O O O O O O O O O O O O W W W W W W W W W W W W W W W W W W W
S S S S S S S S S O O O O O O O O O O O O O O O O O O O O O W W W W W W W W W W W W W W W W W W W
S S S S S S S S S O O O O O O O O O O O O O O O O O O O O O W W W W W W W W W W W W W W W W W W W
S S S S S S S S S O O O O O O O O O O O O O O O O O O O O O W W W W W W W W W W W W W W W W W W W
S S S S S S S S S O O O O O O O O O O O O O O O O O O O O O W W W W W W W W W W W W W W W W W W W
S S S S S S S S S O O O O O O O O O O O O O O O O O O O O O W W W W W W W W W W W W W W W W W W W
S S S S S S S S S O O O O O O O O O O O O O O O O O O O O O W W W W W W W W W W W W W W W W W W W
W W W W S S S S S O O O O O O O O O O O O O O O O O O O O O W W W W W W W W W W W W W W W W W W W
W W W W S S S S S O O O O O O O O O O O O O O O O O O O O O W W W W W W W W W W W W W W W W W W W
W W W W W W W W W W W W W W W W W W W W W W S S W W W W W W W W W W W W W W W W W W W W W W W W W
S S S S S S S S S O O O O O O O O O O O O O O O O O O O O O W W W W W W W W W W W W W W W W W W W
S S S S S S S S S O O O O O O O O O O O O O O O O O O O O O W W W W W W W W W W W W W W W W W W W
S S S S S S S S S O O O O O O O O O O O O O O O O O O O O O W W W W M M M M M M M M M M W W W W W
S S S S S S S S S O O O O O O O O O O O O O O O O O O O O O W W W W M M M M M H M M M M W W W W W
S S S S S S S S S O O O O O O O O O O O O O O O O O O O O O S S S S M M M M M G M M M M W W W W W
S S S S S S S S S O O O O O O O O O O O O O O O O O O O O O W W W G G G G G G G M M M M M W W W W
S S S S S S S S S O O O O O O O O O O O O O O O O O O O O O W W W G W W W W W W W W W W W W W W W
S S S S S S S S S O O O O O O O O O O O O O O O O O O O O O W W W W W W W W W W W W W W W W W W W
S S S S S S S S S O O O O O O O O O O O O O O O O O O O O O W W W W W W W W W W W W W W W W W W W
S S S S S S S S S O O O O O O O O O O O O O O O O O O O O O W W W W W W W W W W W W W W W W W W W
S S S S S S S S S T T T T T T T T T T T T T T T O O O O O O W W W W W W W W W W W W W W W W W W W
S S S S S S S S S O O O O T T T T T T O O O O O O O O O O O W W W W W W W W W W W W W W W W W W W
S S S S S S S S S O O O O O O O O O O O O O O O O O O O O O W W W W W W W W W W W W W W W W W W W
S S S S S S S S S O O O O O O O O O O O O O O O O O O O O O W W W W W W W W W W W W W W W W W W W
S S S S S S S S S O O O O O O O O O O O O O O O O O O O O O W W W W W W W W W W W W W W W W W W W
S S S S S S S S S O O O O O O O O O O O O O O O O O O O O O W W W W W W W W W W W W W W W W W W W
S S S S S S S S S O O O O O O O O O O O O O O O O O O O O O W W W W W W W W W W W W W W W W W W W
S S S S S S S S S O O O O O O O O O O O O O O O O O O O O O W W W W W W W W W W W W W W W W W W W
S S S S S S S S S O O O O O O O O O O O O O O O O O O O O O W W W W W W W W W W W W W W W W W W W
S S S S S S S S S O O O O O O O O O O O O O O O O O O O O O W W W W W W W W W W W W W W W W W W W
S S S S S S S S S O O O O O O O O O O O O O O O O O O O O O W W W W W W W W W W W W W W W W W W W
